12 12
************
*o.........*
*.*.**.*.*.*
**...**..*.*
*.*.*.**.*.*
**.*.*.*.***
*.*****....*
*.**..*.*..*
**.***.*..**
*.....******
*.*.*.....e*
************
