13 12
*************
*o.........**
*.*.**.*.*.**
*....**..*.**
*.*.*.**.*.**
*..*.*.*.****
*..****....**
*.**..*.*..**
*..***.*..***
*.....*******
***.*.....e**
*************
